import pickle

level2_data = [ #the data and the layout of the game
[1, 1, 1, 1, 1, 1, 1, 1, 1, 1, 1, 1, 1, 1, 1, 1, 1, 1, 1, 1], 
[1, 0, 0, 0, 0, 0, 0, 0, 0, 0, 0, 0, 0, 0, 0, 0, 0, 0, 0, 1], 
[1, 0, 0, 0, 0, 0, 0, 0, 0, 0, 0, 0, 0, 0, 0, 0, 0, 0, 0, 1], 
[1, 0, 0, 0, 0, 0, 0, 0, 0, 0, 3, 0, 0, 0, 0, 0, 0, 0, 0, 1], 
[1, 0, 0, 0, 0, 0, 0, 0, 2, 2, 2, 2, 0, 2, 0, 0, 0, 0, 0, 1], 
[1, 0, 0, 2, 2, 2, 4, 2, 2, 2, 2, 2, 0, 2, 2, 0, 0, 0, 0, 1], 
[1, 2, 0, 0, 0, 0, 2, 0, 0, 0, 0, 0, 0, 0, 0, 2, 0, 0, 0, 1], 
[1, 0, 2, 0, 0, 0, 0, 0, 0, 0, 0, 0, 0, 0, 0, 0, 2, 0, 0, 1], 
[1, 0, 0, 0, 2, 0, 0, 0, 0, 0, 3, 0, 0, 0, 0, 0, 0, 2, 2, 1], 
[1, 0, 0, 0, 0, 2, 2, 3, 2, 2, 2, 2, 2, 0, 0, 0, 0, 0, 0, 1], 
[1, 0, 0, 0, 0, 0, 0, 2, 0, 0, 0, 0, 0, 2, 0, 4, 0, 0, 0, 1], 
[1, 0, 4, 4, 0, 0, 0, 0, 0, 0, 0, 0, 0, 0, 2, 2, 2, 0, 0, 1], 
[1, 0, 2, 2, 0, 0, 0, 0, 2, 2, 2, 0, 0, 0, 0, 0, 0, 0, 2, 1], 
[1, 0, 0, 0, 0, 0, 0, 2, 0, 0, 0, 0, 2, 0, 0, 0, 0, 2, 0, 1], 
[1, 0, 0, 0, 0, 0, 2, 0, 4, 0, 0, 0, 0, 2, 0, 2, 2, 0, 0, 1], 
[1, 0, 0, 0, 0, 2, 0, 4, 1, 4, 0, 0, 0, 0, 0, 0, 0, 0, 0, 1], 
[1, 0, 0, 0, 2, 4, 4, 1, 1, 4, 4, 0, 0, 0, 0, 0, 0, 0, 0, 1], 
[1, 0, 0, 2, 1, 1, 1, 1, 1, 1, 4, 4, 4, 0, 0, 0, 4, 0, 0, 1], 
[1, 0, 2, 1, 1, 1, 1, 1, 1, 1, 1, 1, 4, 4, 4, 4, 4, 4, 1, 1], 
[1, 1, 1, 1, 1, 1, 1, 1, 1, 1, 1, 1, 1, 1, 1, 1, 1, 1, 1, 1]
]

with open("level2_data.pk1", "wb") as file:
    pickle.dump(level2_data, file)
print("Level data saved!")
